[Tileset]
Name=testspritesheet
Columns=5
Rows=3

[MapMetaData]
Width=19
Height=11
TileSize=128
Walls={5,10}

[Tilemap]
 5, 5, 5, 0, 1, 9, 9, 3, 0, 0, 0, 0,10,10,10,10,10,10,10
 5, 5, 5, 0, 4, 0, 0, 6, 9, 2, 9, 3,10,10,10,10,10,10,10
 5, 5, 5, 0, 4, 0, 1,13, 0, 4, 0, 4,10,10,10,10,10,10,10
 5, 5, 5, 0, 4, 0,11, 9, 2, 7, 9,13,10,10,10,10,10,10,10
 5, 5, 5, 0, 4, 0, 0, 0, 4, 6, 9, 3, 0,10,10,10,10,10,10
 5, 5, 5, 0, 6, 9, 9, 9,13, 4, 1,12, 3, 0,10,10,10,10,10
 5, 5, 0, 0, 4, 0, 0, 0, 0,11,13, 0, 3, 0,10,10,10,10,10
 5, 5, 0, 1,13, 0, 0,10,10,10,10, 0,11, 9, 3, 0,10,10,10
 5, 5, 0, 4, 0, 0,10,10,10,10,10,10,10, 0,11, 9, 9, 9, 9
 5, 0, 1,13,10,10,10,10,10,10,10,10,10,10,10,10, 0, 0, 0
 9, 9,13,10,10,10,10,10,10,10,10,10,10,10,10,10,10,10, 0
