[Tileset]
Name = mountain_range_tileset
TileSize = 8

[MapMetaData]
Width = 25
Height = 26
TileSize = 96
Walls = { 0, 10, 13, 18 }
Spawn = { 4, 4 }

[Tilemap]
13,13,13,13,13,13,18,18,18,18,18,18,18,18,18,18,18,18,18,18,18,18,18,18,18
 2, 3,13,13,13,13,13,13,13,13,18,18,18,18,18,18,18,18,18,18,18,13,13,13,13
 2, 2, 2, 3, 3,13,13,13,13,13,13,18,18,18,18,18,18,18,13,13,13,13,13,13,13
13, 3, 2, 2, 3, 3, 3, 3, 3,13,13,13,18,18,18,18,18,13,13,13,13,13, 3, 3, 3
13,13, 3, 2, 2, 3, 3, 3, 3, 3,13,13,13,18,18,18,13,13,13, 3, 3, 3, 3, 2, 2
13,13, 3, 3, 2, 2, 2, 2, 3, 3, 3,13,13,18,18,18,13,13, 3, 3, 2, 2, 2, 2, 3
13,13,13, 3, 3, 3, 3, 2, 2, 3, 3,13,13,18,18,18,13,13, 3, 2, 2, 3, 3, 3,13
18,13,13,13, 3, 3, 3, 3, 2, 2, 3,13,13,13,18,18,13, 3, 3, 2, 3, 3, 3,13,13
18,18,18,13,13,13, 3, 3, 3, 2, 3, 3,13,13,18,13,13, 3, 2, 2, 3,13,13,13,18
18,18,18,18,13,13,13, 3, 3, 2, 3, 3,13,13,13,13, 3, 3, 2, 3, 3,13,18,18,18
18,18,18,18,18,13,13, 3, 3, 2, 3, 3, 3, 3,13,13, 3, 3, 2, 3,13,13,13,18,18
18,18,18,18,18,13,13, 3, 3, 2, 2, 3, 3, 3, 3, 3, 3, 2, 2, 3, 3, 3,13,13,18
18,18,18,18,18,13,13, 3, 3, 3, 2, 2, 2, 3, 3, 2, 2, 2, 3, 3, 3, 3, 3,13,13
18,18,18,18,18,13,13,13, 3, 3, 2, 3, 2, 2, 2, 2, 3, 3,10,10,10, 3, 3, 3,13
18,18,18,18,18,18,13,13, 3, 3, 2, 3, 3, 3, 3, 3, 3,10,10,10,10,10, 3, 3,13
18,18,18,18,18,18,13,13, 3, 3, 2, 2, 3,10, 3, 3, 3,10,10,10,10,10, 3, 3, 3
18,18,18,18,18,18,13,13, 3, 3, 3, 2, 3,10,10, 3, 3, 3,10,10,10,10, 3, 3, 3
18,18,18,18,18,18,13,13, 3, 3, 3, 2, 2, 3, 3, 3, 3, 3, 3, 3,10, 3, 3, 3, 3
18,18,18,18,18,18,13,13,14, 3, 3, 3, 2, 2, 2, 3, 3, 3, 3, 3, 3, 3, 3, 3, 1
18,18,18,13,13,13,13,14,14,14, 3, 3, 3, 3, 2, 3, 3, 3, 1, 1, 3, 3, 1, 1,13
12,12,12,12,12,12,12,14,14,14,14, 3, 3, 3, 2, 3, 3,13,13, 1, 1, 1, 1,13,13
 8, 8, 8, 8, 8, 8, 8,12,14,14,14,13, 3, 3, 2, 3, 3,13,13,13, 0,13,13,13,13
12,12,12,12,12,12,12,12,14,14,13,13, 3, 3, 2, 2, 3,13,18,13, 0,13,13,18,18
13,13,13,13,13,13,13,13,13,13,13,13,13, 3, 3, 2, 3,13,13,18,13, 0,18,18,18
18,18,13,13,13,18,18,18,18,18,18,13,13, 3, 3, 2, 3, 3,13,18,18, 0,18, 0, 0
18,18,18,18,18,18,18,18,18,18,18,18,13,13, 3, 2, 3, 3,13,18, 0, 0, 0, 0, 0

[Exit]
Tile = { 0, 1 }
Level = testmap1
Destination = { 18, 9 }

[Exit]
Tile = { 24, 4 }
Level = testmap1

[Exit]
Tile = { 15, 25 }
Level = testmap1
Destination = { 0, 10 }

[Exit]
Tile = { 0, 21 }
Level = testmap2

[Enemy]
Position = { 7, 6 }
PatrolPoints = { { 7, 6 }, { 9, 7 }, { 9, 12 } }
PatrolType = Boomerang

[Enemy]
Position = { 19, 7 }

[Enemy]
Position = { 15, 24 }

[Enemy]
Position = { 15, 15 }
PatrolPoints = { { 15, 15 }, { 17, 11 }, { 22, 13 }, { 23, 17 }, { 20, 19 } }
PatrolType = Circular

[Enemy]
Sprite = Burgundy_Enemy
Position = { 2, 20 }
RotationSpeed = 3
Speed = 150
Damage = 15
AttackRange = 150
AttackWindup = 1.2
AttackLinger = 0.2
AttackCooldown = 1

[Enemy]
Position = { 2, 22 }
Sprite = Dark_Blue_Enemy
RotationSpeed = 3
Speed = 150
Damage = 15
AttackRange = 120
AttackWindup = 1.7
AttackLinger = 0.7
AttackCooldown = 1.5